



SO ./textures/south.xpm

WE ./textures/west.xpm

F 5,50,252

C 120,120,120
EA ./textures/east.xpm

NO ./textures/north.xpm






111111111111111111111
101000001010100000001
101010101011111110001
100010100010000010001
111110101111101011101
100000101011101000001
10111110101 101111111
101000001011100000101
101011111010111110101
101010001010100010101
101110101010101010101
100000101010001010001
111111101111111011101
100000101000100010001
101110101110101110111
101000100000100010101
101011111111110101011
100010000000000010001
1010101110N1111111101
101000001000000000001
111111111111111111111