NO ./textures/north.xpm
SO ./textures/south.xpm
WE ./textures/west.xpm
EA ./textures/east.xpm

F 220,100,0
C 225,230,255

        1111111111111111111111111111111111111111111111111111
      11000000000000000000000000000000000000000000000000000011
    110000000000000000000000000000000000000000000000000000000011
   11000000000000000000000000000000000000000000000000000000000011
  1100000000000000000000000000000000000000000000000000000000000011
 110000000000000000000000000000000000000000000000000000000000000011
 11000000000000000000000000000000000000000000000000000000000000000011
1100000000000000000000000000000000000000000000000000000000000000000011
110000000000000000000000000000000000000000000000000000000000000000000011
11000000000000000000000000000000000000000000000000000000000000000000000011
1100000000000000000000000000000000000000000000000000000000000000000000000011
110000000000000000000000000000000000000000000000000000000000000000000000000011
11000000000000000000000000000000000000000000000000000000000000000000000000000011
1100000000000000000000000000000000000000000000000000000000000000000000000000000011
110000000000000000000000000000000000000000000000000000000000000000000000000000000011
11000000000000000000000000000000000000000000000000000000000000000000000000000000000011
1100000000000000000000000000000000000000000000000000000000000000000000000000000000000011
110000000000000000000000000000000000000000000000000000000000000000000000000000000000000011
110000000000000111111111111111100111111111111111111111111111111111111111110000000000000011
11000000000000110000000000000000000000000000000000000000000000000000000000110000000000000011
1100000000000110000000000000000000000000000000000000000000000000000000000001100000000000000011
110000000000110000000000000000000000000000000000000000000000000000000000000011000000000000000011
11000000000110000000001111111111111111111111111111111111111111110000000000001100000000000000011
1100000000110000000011000000000000000000000000000000000000000000110000000000011000000000000000011
110000000110000000011000000000000000000000000000000000000000000001100000000001100000000000000011
11000000110000000011000000000000000000000000000000000000000000000011000000000011000000000000000011
1100000110000000110000000001111111111111111111111111111110000000001100000000001100000000000000011
110000110000000110000000011000000000000000000000000000001100000000011000000000011000000000000000011
11000110000000110000000110000000000000000000000000000000011000000001100000000001100000000000000011
1100110000000110000000110000000001111111111111111100000001100000000110000000000110000000000000011
110110000000110000000110000000011000000000000000001100000011000000001100000000001100000000000000011
11110000000110000000110000000110000000000000000000011000000000000000110000000000110000000000000011
11100000000110000000110000001100000000000000000000001100000110000000011000000000011000000000000011
1110000000000000000110000001100000000000000000000000110000011000000001100000000001100000000000011
111000000110000000110000001100000000000000000000000011000001100000000110000000000110000000000011
111000000110000000110000001100000000000N00000000000000000001100000000110000000000110000000000011
111000000110000000110000001100000000000000000000000011000001100000000110000000000110000000000011
1110000000110000000110000001100000000000000000000000110000011000000001100000000001100000000000011
11100000000110000000110000001100000000000000000000001100000110000000011000000000011000000000000011
11110000000110000000110000000110000000000000000000011000001100000000110000000000110000000000000011
110110000000110000000110000000011000000000000000001100000011000000001100000000001100000000000000011
1100110000000110000000110000000001111111111111111100000001100000000110000000000110000000000000011
11000110000000110000000110000000000000000000000000000000011000000001100000000001100000000000000011
110000110000000110000000011000000000000000000000000000001100000000011000000000011000000000000000011
1100000110000000110000000001100000000000000000000000001100000000001100000000001100000000000000011
11000000110000000011000000000011000000000000000000000011000000000011000000000011000000000000000011
110000000110000000011000000000001100000000000000000001100000000001100000000001100000000000000011
1100000000110000000001100000000000110000000000000000110000000000011000000000011000000000000000011
11000000000110000000000110000000000111111111111111110000000000001100000000001100000000000000011
110000000000110000000000011000000000000000000000000000000000000011000000000011000000000000000011
1100000000000110000000000001100000000000000000000000000000000001100000000001100000000000000011
11000000000000110000000000000110000000000000000000000000000000110000000000011000000000000000011
110000000000000110000000000000011111111111111111111111111111110000000000001100000000000000011
1100000000000001100000000000000000000000000000000000000000000000000000000001100000000000000011
11000000000000001100000000000000000000000000000000000000000000000000000000011000000000000000011
110000000000000001100000000000000000000000000000000000000000000000000000000110000000000000011
1100000000000000001111111111111111111111111111111111111111111111111111111110000000000000011
11000000000000000000000000000000000000000000000000000000000000000000000000000000000000000011
110000000000000000000000000000000000000000000000000000000000000000000000000000000000000011
1100000000000000000000000000000000000000000000000000000000000000000000000000000000000011
11000000000000000000000000000000000000000000000000000000000000000000000000000000000011
110000000000000000000000000000000000000000000000000000000000000000000000000000000011
1100000000000000000000000000000000000000000000000000000000000000000000000000000011
11000000000000000000000000000000000000000000000000000000000000000000000000000011
110000000000000000000000000000000000000000000000000000000000000000000000000011
1100000000000000000000000000000000000000000000000000000000000000000000000011
 11000000000000000000000000000000000000000000000000000000000000000000000011
 110000000000000000000000000000000000000000000000000000000000000000000011
  1100000000000000000000000000000000000000000000000000000000000000000011
   11000000000000000000000000000000000000000000000000000000000000000011
    110000000000000000000000000000000000000000000000000000000000000011
      11000000000000000000000000000000000000000000000000000000000011
        1111111111111111111111111111111111111111111111111111111111