NO ./textures/north.xpm
SO ./textures/south.xpm
WE ./textures/west.xpm
EA ./textures/east.xpm

F 50,50,50
C 120,120,120

11111111111111111111111111111111111111111111111111111111111111111111111111
10000000000000000000000000000000000000000000000000000000000000000000000001
10000000000000000111111111111111111000000000000000000000000000000000000001
10000000000000000000000000000000000111111111111110000000000000000000000001
10000000000000111110000000000000000111111111111111110000000000000000000001
10000000000000111111111110000000000111111111111111110000000000000000000001
10000000000000111111111111111111000111111111111111110000000000000000000001
10000000000000111111111111111111000111111111111111110000000000000000000001
10000000000000111111111111111111000111111111111111110000000000000000000001
10000000000000000000000000000000000111111111111111110000000000000000000001
10000000000000000000000000000000000000000000000000000000000000000000000001
10000000111111111111000000000000000000000000000000000000000000000000000001
10000000111111111111000000000000000111111111111111110000000000000000000001
10000000111111111111000000000000000111111111111111110000000000000000000001
10000000111111111111000000000000000111111111111111110000000000000000000001
10000000111111111111000000000000000111111111111111110000000000000000000001
10000000111111111111000000000000000111111111111111110000000000000000000001
10000000000000000000000000000000000111111111111111110000000000000000000001
10000000000000000000000000000000000111111111111111110000000000000000000001
10000000000000000000000000000000000111111111111111110000000000000000000001
10000000000000000000000000000000000000000000000000000000000000000000000001
10000000000000000000000000000000000111111111111111110000000000000000000001
10000000000000000000000000000000000110000000000000110000000000000000000001
10000000000000000000000000000000000111111110111110110000000000000000000001
10000000000000000000000000000000000111111110111110110000000000000000000001
10000000000000000000000000000000000111111110111110110000000000000000000001
10000000000011111111111111111111111111111110111111111111111111111111100001
1000000010000000000000000000000000000000000N000000000000000000000000000001
10000001000000000000000000000000000000000000000000000000000000000000000001
10000000000000000000000000000000000000000000000000000000000000000000000001
10000000111111111111111111111111000000000000000000000000000000000000000001
10000000000000000000000000000000000111111111111111110000000000000000000001
10000000000000000000000000000000000111111111111111110000000000000000000001
10000000000000000000000000000000000111111111111111110000000000000000000001
10000000000000000000000000000000000111111111111111110000000000000000000001
10000000000000000000000000000000000111111111111111110000000000000000000001
10000000000000000000000000000000000111111111111111110000000000000000000001
10000000000000000000000000000000000111111111111111110000000000000000000001
11111111111111111111111111111111111111111111111111111111111111111111111111